,CCC,CCD,CDC,CDD,DCC,DCD,DDC,DDD
0,4,4,-4,-4,4,4,-4,-4
1,6,6,-2,-6,2,2,-2,-6
2,9,9,2,-9,0,-2,0,-9
3,12,12,5,-12,1,-5,-1,-12
4,15,15,8,-15,0,-8,0,-15
5,18,18,11,-18,1,-11,-1,-18
6,21,21,14,-21,0,-14,0,-21
7,24,24,17,-24,1,-17,-1,-24
8,27,27,20,-27,0,-20,0,-27
9,30,30,23,-30,1,-23,-1,-30
10,33,33,26,-33,0,-26,0,-33
11,36,36,29,-36,1,-29,-1,-36
12,39,39,32,-39,0,-32,0,-39
13,42,42,35,-42,1,-35,-1,-42
14,45,45,38,-45,0,-38,0,-45
15,48,48,41,-48,1,-41,-1,-48
16,51,51,44,-51,0,-44,0,-51
17,54,54,47,-54,1,-47,-1,-54
18,57,57,50,-57,0,-50,0,-57
19,60,60,53,-60,1,-53,-1,-60
20,63,63,56,-63,0,-56,0,-63
21,66,66,59,-66,1,-59,-1,-66
22,69,69,62,-69,0,-62,0,-69
23,72,72,65,-72,1,-65,-1,-72
24,75,75,68,-75,0,-68,0,-75
25,78,78,71,-78,1,-71,-1,-78
26,81,81,74,-81,0,-74,0,-81
27,84,84,77,-84,1,-77,-1,-84
28,87,87,80,-87,0,-80,0,-87
29,90,90,83,-90,1,-83,-1,-90
30,93,93,86,-93,0,-86,0,-93
31,96,96,89,-96,1,-89,-1,-96
32,99,99,92,-99,0,-92,0,-99
33,102,102,95,-102,1,-95,-1,-102
34,105,105,98,-105,0,-98,0,-105
35,108,108,101,-108,1,-101,-1,-108
36,111,111,104,-111,0,-104,0,-111
37,114,114,107,-114,1,-107,-1,-114
38,117,117,110,-117,0,-110,0,-117
39,120,120,113,-120,1,-113,-1,-120
40,123,123,116,-123,0,-116,0,-123
41,126,126,119,-126,1,-119,-1,-126
42,129,129,122,-129,0,-122,0,-129
43,132,132,125,-132,1,-125,-1,-132
44,135,135,128,-135,0,-128,0,-135
45,138,138,131,-138,1,-131,-1,-138
46,141,141,134,-141,0,-134,0,-141
47,144,144,137,-144,1,-137,-1,-144
48,147,147,140,-147,0,-140,0,-147
49,150,150,143,-150,1,-143,-1,-150
50,153,153,146,-153,0,-146,0,-153
51,156,156,149,-156,1,-149,-1,-156
52,159,159,152,-159,0,-152,0,-159
53,162,162,155,-162,1,-155,-1,-162
54,165,165,158,-165,0,-158,0,-165
55,168,168,161,-168,1,-161,-1,-168
56,171,171,164,-171,0,-164,0,-171
57,174,174,167,-174,1,-167,-1,-174
58,177,177,170,-177,0,-170,0,-177
59,180,180,173,-180,1,-173,-1,-180
60,183,183,176,-183,0,-176,0,-183
61,186,186,179,-186,1,-179,-1,-186
62,189,189,182,-189,0,-182,0,-189
63,192,192,185,-192,1,-185,-1,-192
64,195,195,188,-195,0,-188,0,-195
65,198,198,191,-198,1,-191,-1,-198
66,201,201,194,-201,0,-194,0,-201
67,204,204,197,-204,1,-197,-1,-204
68,207,207,200,-207,0,-200,0,-207
69,210,210,203,-210,1,-203,-1,-210
70,213,213,206,-213,0,-206,0,-213
71,216,216,209,-216,1,-209,-1,-216
72,219,219,212,-219,0,-212,0,-219
73,222,222,215,-222,1,-215,-1,-222
74,225,225,218,-225,0,-218,0,-225
75,228,228,221,-228,1,-221,-1,-228
76,231,231,224,-231,0,-224,0,-231
77,234,234,227,-234,1,-227,-1,-234
78,237,237,230,-237,0,-230,0,-237
79,240,240,233,-240,1,-233,-1,-240
80,243,243,236,-243,0,-236,0,-243
81,246,246,239,-246,1,-239,-1,-246
82,249,249,242,-249,0,-242,0,-249
83,252,252,245,-252,1,-245,-1,-252
84,255,255,248,-255,0,-248,0,-255
85,258,258,251,-258,1,-251,-1,-258
86,261,261,254,-261,0,-254,0,-261
87,264,264,257,-264,1,-257,-1,-264
88,267,267,260,-267,0,-260,0,-267
89,270,270,263,-270,1,-263,-1,-270
90,273,273,266,-273,0,-266,0,-273
91,276,276,269,-276,1,-269,-1,-276
92,279,279,272,-279,0,-272,0,-279
93,282,282,275,-282,1,-275,-1,-282
94,285,285,278,-285,0,-278,0,-285
95,288,288,281,-288,1,-281,-1,-288
96,291,291,284,-291,0,-284,0,-291
97,294,294,287,-294,1,-287,-1,-294
98,297,297,290,-297,0,-290,0,-297
99,300,300,293,-300,1,-293,-1,-300
100,303,303,296,-303,0,-296,0,-303
101,306,306,299,-306,1,-299,-1,-306
102,309,309,302,-309,0,-302,0,-309
103,312,312,305,-312,1,-305,-1,-312
104,315,315,308,-315,0,-308,0,-315
105,318,318,311,-318,1,-311,-1,-318
106,321,321,314,-321,0,-314,0,-321
107,324,324,317,-324,1,-317,-1,-324
108,327,327,320,-327,0,-320,0,-327
109,330,330,323,-330,1,-323,-1,-330
110,333,333,326,-333,0,-326,0,-333
111,336,336,329,-336,1,-329,-1,-336
112,339,339,332,-339,0,-332,0,-339
113,342,342,335,-342,1,-335,-1,-342
114,345,345,338,-345,0,-338,0,-345
115,348,348,341,-348,1,-341,-1,-348
116,351,351,344,-351,0,-344,0,-351
117,354,354,347,-354,1,-347,-1,-354
118,357,357,350,-357,0,-350,0,-357
119,360,360,353,-360,1,-353,-1,-360
120,363,363,356,-363,0,-356,0,-363
121,366,366,359,-366,1,-359,-1,-366
122,369,369,362,-369,0,-362,0,-369
123,372,372,365,-372,1,-365,-1,-372
124,375,375,368,-375,0,-368,0,-375
125,378,378,371,-378,1,-371,-1,-378
126,381,381,374,-381,0,-374,0,-381
127,384,384,377,-384,1,-377,-1,-384
128,387,387,380,-387,0,-380,0,-387
129,390,390,383,-390,1,-383,-1,-390
130,393,393,386,-393,0,-386,0,-393
131,396,396,389,-396,1,-389,-1,-396
132,399,399,392,-399,0,-392,0,-399
133,402,402,395,-402,1,-395,-1,-402
134,405,405,398,-405,0,-398,0,-405
135,408,408,401,-408,1,-401,-1,-408
136,411,411,404,-411,0,-404,0,-411
137,414,414,407,-414,1,-407,-1,-414
138,417,417,410,-417,0,-410,0,-417
139,420,420,413,-420,1,-413,-1,-420
140,423,423,416,-423,0,-416,0,-423
141,426,426,419,-426,1,-419,-1,-426
142,429,429,422,-429,0,-422,0,-429
143,432,432,425,-432,1,-425,-1,-432
144,435,435,428,-435,0,-428,0,-435
145,438,438,431,-438,1,-431,-1,-438
146,441,441,434,-441,0,-434,0,-441
147,444,444,437,-444,1,-437,-1,-444
148,447,447,440,-447,0,-440,0,-447
149,450,450,443,-450,1,-443,-1,-450
150,453,453,446,-453,0,-446,0,-453
151,456,456,449,-456,1,-449,-1,-456
152,459,459,452,-459,0,-452,0,-459
153,462,462,455,-462,1,-455,-1,-462
154,465,465,458,-465,0,-458,0,-465
155,468,468,461,-468,1,-461,-1,-468
156,471,471,464,-471,0,-464,0,-471
157,474,474,467,-474,1,-467,-1,-474
158,477,477,470,-477,0,-470,0,-477
159,480,480,473,-480,1,-473,-1,-480
160,483,483,476,-483,0,-476,0,-483
161,486,486,479,-486,1,-479,-1,-486
162,489,489,482,-489,0,-482,0,-489
163,492,492,485,-492,1,-485,-1,-492
164,495,495,488,-495,0,-488,0,-495
165,498,498,491,-498,1,-491,-1,-498
166,501,501,494,-501,0,-494,0,-501
167,504,504,497,-504,1,-497,-1,-504
168,507,507,500,-507,0,-500,0,-507
169,510,510,503,-510,1,-503,-1,-510
170,513,513,506,-513,0,-506,0,-513
171,516,516,509,-516,1,-509,-1,-516
172,519,519,512,-519,0,-512,0,-519
173,522,522,515,-522,1,-515,-1,-522
174,525,525,518,-525,0,-518,0,-525
175,528,528,521,-528,1,-521,-1,-528
176,531,531,524,-531,0,-524,0,-531
177,534,534,527,-534,1,-527,-1,-534
178,537,537,530,-537,0,-530,0,-537
179,540,540,533,-540,1,-533,-1,-540
180,543,543,536,-543,0,-536,0,-543
181,546,546,539,-546,1,-539,-1,-546
182,549,549,542,-549,0,-542,0,-549
183,552,552,545,-552,1,-545,-1,-552
184,555,555,548,-555,0,-548,0,-555
185,558,558,551,-558,1,-551,-1,-558
186,561,561,554,-561,0,-554,0,-561
187,564,564,557,-564,1,-557,-1,-564
188,567,567,560,-567,0,-560,0,-567
189,570,570,563,-570,1,-563,-1,-570
190,573,573,566,-573,0,-566,0,-573
191,576,576,569,-576,1,-569,-1,-576
192,579,579,572,-579,0,-572,0,-579
193,582,582,575,-582,1,-575,-1,-582
194,585,585,578,-585,0,-578,0,-585
195,588,588,581,-588,1,-581,-1,-588
196,591,591,584,-591,0,-584,0,-591
197,594,594,587,-594,1,-587,-1,-594
198,597,597,590,-597,0,-590,0,-597
199,600,600,593,-600,1,-593,-1,-600
200,603,603,596,-603,0,-596,0,-603
201,606,606,599,-606,1,-599,-1,-606
202,609,609,602,-609,0,-602,0,-609
203,612,612,605,-612,1,-605,-1,-612
204,615,615,608,-615,0,-608,0,-615
205,618,618,611,-618,1,-611,-1,-618
206,621,621,614,-621,0,-614,0,-621
207,624,624,617,-624,1,-617,-1,-624
208,627,627,620,-627,0,-620,0,-627
209,630,630,623,-630,1,-623,-1,-630
210,633,633,626,-633,0,-626,0,-633
211,636,636,629,-636,1,-629,-1,-636
212,639,639,632,-639,0,-632,0,-639
213,642,642,635,-642,1,-635,-1,-642
214,645,645,638,-645,0,-638,0,-645
215,648,648,641,-648,1,-641,-1,-648
216,651,651,644,-651,0,-644,0,-651
217,654,654,647,-654,1,-647,-1,-654
218,657,657,650,-657,0,-650,0,-657
219,660,660,653,-660,1,-653,-1,-660
220,663,663,656,-663,0,-656,0,-663
221,666,666,659,-666,1,-659,-1,-666
222,669,669,662,-669,0,-662,0,-669
223,672,672,665,-672,1,-665,-1,-672
224,675,675,668,-675,0,-668,0,-675
225,678,678,671,-678,1,-671,-1,-678
226,681,681,674,-681,0,-674,0,-681
227,684,684,677,-684,1,-677,-1,-684
228,687,687,680,-687,0,-680,0,-687
229,690,690,683,-690,1,-683,-1,-690
230,693,693,686,-693,0,-686,0,-693
231,696,696,689,-696,1,-689,-1,-696
232,699,699,692,-699,0,-692,0,-699
233,702,702,695,-702,1,-695,-1,-702
234,705,705,698,-705,0,-698,0,-705
235,708,708,701,-708,1,-701,-1,-708
236,711,711,704,-711,0,-704,0,-711
237,714,714,707,-714,1,-707,-1,-714
238,717,717,710,-717,0,-710,0,-717
239,720,720,713,-720,1,-713,-1,-720
240,723,723,716,-723,0,-716,0,-723
241,726,726,719,-726,1,-719,-1,-726
242,729,729,722,-729,0,-722,0,-729
243,732,732,725,-732,1,-725,-1,-732
244,735,735,728,-735,0,-728,0,-735
245,738,738,731,-738,1,-731,-1,-738
246,741,741,734,-741,0,-734,0,-741
247,744,744,737,-744,1,-737,-1,-744
248,747,747,740,-747,0,-740,0,-747
249,750,750,743,-750,1,-743,-1,-750
250,753,753,746,-753,0,-746,0,-753
251,756,756,749,-756,1,-749,-1,-756
252,759,759,752,-759,0,-752,0,-759
253,762,762,755,-762,1,-755,-1,-762
254,765,765,758,-765,0,-758,0,-765
255,768,768,761,-768,1,-761,-1,-768
256,771,771,764,-771,0,-764,0,-771
257,774,774,767,-774,1,-767,-1,-774
258,777,777,770,-777,0,-770,0,-777
259,780,780,773,-780,1,-773,-1,-780
260,783,783,776,-783,0,-776,0,-783
261,786,786,779,-786,1,-779,-1,-786
262,789,789,782,-789,0,-782,0,-789
263,792,792,785,-792,1,-785,-1,-792
264,795,795,788,-795,0,-788,0,-795
265,798,798,791,-798,1,-791,-1,-798
266,801,801,794,-801,0,-794,0,-801
267,804,804,797,-804,1,-797,-1,-804
268,807,807,800,-807,0,-800,0,-807
269,810,810,803,-810,1,-803,-1,-810
270,813,813,806,-813,0,-806,0,-813
271,816,816,809,-816,1,-809,-1,-816
272,819,819,812,-819,0,-812,0,-819
273,822,822,815,-822,1,-815,-1,-822
274,825,825,818,-825,0,-818,0,-825
275,828,828,821,-828,1,-821,-1,-828
276,831,831,824,-831,0,-824,0,-831
277,834,834,827,-834,1,-827,-1,-834
278,837,837,830,-837,0,-830,0,-837
279,840,840,833,-840,1,-833,-1,-840
280,843,843,836,-843,0,-836,0,-843
281,846,846,839,-846,1,-839,-1,-846
282,849,849,842,-849,0,-842,0,-849
283,852,852,845,-852,1,-845,-1,-852
284,855,855,848,-855,0,-848,0,-855
285,858,858,851,-858,1,-851,-1,-858
286,861,861,854,-861,0,-854,0,-861
287,864,864,857,-864,1,-857,-1,-864
288,867,867,860,-867,0,-860,0,-867
289,870,870,863,-870,1,-863,-1,-870
290,873,873,866,-873,0,-866,0,-873
291,876,876,869,-876,1,-869,-1,-876
292,879,879,872,-879,0,-872,0,-879
293,882,882,875,-882,1,-875,-1,-882
294,885,885,878,-885,0,-878,0,-885
295,888,888,881,-888,1,-881,-1,-888
296,891,891,884,-891,0,-884,0,-891
297,894,894,887,-894,1,-887,-1,-894
298,897,897,890,-897,0,-890,0,-897
299,900,900,893,-900,1,-893,-1,-900
300,903,903,896,-903,0,-896,0,-903
301,906,906,899,-906,1,-899,-1,-906
302,909,909,902,-909,0,-902,0,-909
303,912,912,905,-912,1,-905,-1,-912
304,915,915,908,-915,0,-908,0,-915
305,918,918,911,-918,1,-911,-1,-918
306,921,921,914,-921,0,-914,0,-921
307,924,924,917,-924,1,-917,-1,-924
308,927,927,920,-927,0,-920,0,-927
309,930,930,923,-930,1,-923,-1,-930
310,933,933,926,-933,0,-926,0,-933
311,936,936,929,-936,1,-929,-1,-936
312,939,939,932,-939,0,-932,0,-939
313,942,942,935,-942,1,-935,-1,-942
314,945,945,938,-945,0,-938,0,-945
315,948,948,941,-948,1,-941,-1,-948
316,951,951,944,-951,0,-944,0,-951
317,954,954,947,-954,1,-947,-1,-954
318,957,957,950,-957,0,-950,0,-957
319,960,960,953,-960,1,-953,-1,-960
320,963,963,956,-963,0,-956,0,-963
321,966,966,959,-966,1,-959,-1,-966
322,969,969,962,-969,0,-962,0,-969
323,972,972,965,-972,1,-965,-1,-972
324,975,975,968,-975,0,-968,0,-975
325,978,978,971,-978,1,-971,-1,-978
326,981,981,974,-981,0,-974,0,-981
327,984,984,977,-984,1,-977,-1,-984
328,987,987,980,-987,0,-980,0,-987
329,990,990,983,-990,1,-983,-1,-990
330,993,993,986,-993,0,-986,0,-993
331,996,996,989,-996,1,-989,-1,-996
332,999,999,992,-999,0,-992,0,-999
333,1002,1002,995,-1002,1,-995,-1,-1002
334,1005,1005,998,-1005,0,-998,0,-1005
335,1008,1008,1001,-1008,1,-1001,-1,-1008
336,1011,1011,1004,-1011,0,-1004,0,-1011
337,1014,1014,1007,-1014,1,-1007,-1,-1014
338,1017,1017,1010,-1017,0,-1010,0,-1017
339,1020,1020,1013,-1020,1,-1013,-1,-1020
340,1023,1023,1016,-1023,0,-1016,0,-1023
341,1026,1026,1019,-1026,1,-1019,-1,-1026
342,1029,1029,1022,-1029,0,-1022,0,-1029
343,1032,1032,1025,-1032,1,-1025,-1,-1032
344,1035,1035,1028,-1035,0,-1028,0,-1035
345,1038,1038,1031,-1038,1,-1031,-1,-1038
346,1041,1041,1034,-1041,0,-1034,0,-1041
347,1044,1044,1037,-1044,1,-1037,-1,-1044
348,1047,1047,1040,-1047,0,-1040,0,-1047
349,1050,1050,1043,-1050,1,-1043,-1,-1050
350,1053,1053,1046,-1053,0,-1046,0,-1053
351,1056,1056,1049,-1056,1,-1049,-1,-1056
352,1059,1059,1052,-1059,0,-1052,0,-1059
353,1062,1062,1055,-1062,1,-1055,-1,-1062
354,1065,1065,1058,-1065,0,-1058,0,-1065
355,1068,1068,1061,-1068,1,-1061,-1,-1068
356,1071,1071,1064,-1071,0,-1064,0,-1071
357,1074,1074,1067,-1074,1,-1067,-1,-1074
358,1077,1077,1070,-1077,0,-1070,0,-1077
359,1080,1080,1073,-1080,1,-1073,-1,-1080
360,1083,1083,1076,-1083,0,-1076,0,-1083
361,1086,1086,1079,-1086,1,-1079,-1,-1086
362,1089,1089,1082,-1089,0,-1082,0,-1089
363,1092,1092,1085,-1092,1,-1085,-1,-1092
364,1095,1095,1088,-1095,0,-1088,0,-1095
365,1098,1098,1091,-1098,1,-1091,-1,-1098
366,1101,1101,1094,-1101,0,-1094,0,-1101
367,1104,1104,1097,-1104,1,-1097,-1,-1104
368,1107,1107,1100,-1107,0,-1100,0,-1107
369,1110,1110,1103,-1110,1,-1103,-1,-1110
370,1113,1113,1106,-1113,0,-1106,0,-1113
371,1116,1116,1109,-1116,1,-1109,-1,-1116
372,1119,1119,1112,-1119,0,-1112,0,-1119
373,1122,1122,1115,-1122,1,-1115,-1,-1122
374,1125,1125,1118,-1125,0,-1118,0,-1125
375,1128,1128,1121,-1128,1,-1121,-1,-1128
376,1131,1131,1124,-1131,0,-1124,0,-1131
377,1134,1134,1127,-1134,1,-1127,-1,-1134
378,1137,1137,1130,-1137,0,-1130,0,-1137
379,1140,1140,1133,-1140,1,-1133,-1,-1140
380,1143,1143,1136,-1143,0,-1136,0,-1143
381,1146,1146,1139,-1146,1,-1139,-1,-1146
382,1149,1149,1142,-1149,0,-1142,0,-1149
383,1152,1152,1145,-1152,1,-1145,-1,-1152
384,1155,1155,1148,-1155,0,-1148,0,-1155
385,1158,1158,1151,-1158,1,-1151,-1,-1158
386,1161,1161,1154,-1161,0,-1154,0,-1161
387,1164,1164,1157,-1164,1,-1157,-1,-1164
388,1167,1167,1160,-1167,0,-1160,0,-1167
389,1170,1170,1163,-1170,1,-1163,-1,-1170
390,1173,1173,1166,-1173,0,-1166,0,-1173
391,1176,1176,1169,-1176,1,-1169,-1,-1176
392,1179,1179,1172,-1179,0,-1172,0,-1179
393,1182,1182,1175,-1182,1,-1175,-1,-1182
394,1185,1185,1178,-1185,0,-1178,0,-1185
395,1188,1188,1181,-1188,1,-1181,-1,-1188
396,1191,1191,1184,-1191,0,-1184,0,-1191
397,1194,1194,1187,-1194,1,-1187,-1,-1194
398,1197,1197,1190,-1197,0,-1190,0,-1197
399,1200,1200,1193,-1200,1,-1193,-1,-1200
400,1203,1203,1196,-1203,0,-1196,0,-1203
401,1206,1206,1199,-1206,1,-1199,-1,-1206
402,1209,1209,1202,-1209,0,-1202,0,-1209
403,1212,1212,1205,-1212,1,-1205,-1,-1212
404,1215,1215,1208,-1215,0,-1208,0,-1215
405,1218,1218,1211,-1218,1,-1211,-1,-1218
406,1221,1221,1214,-1221,0,-1214,0,-1221
407,1224,1224,1217,-1224,1,-1217,-1,-1224
408,1227,1227,1220,-1227,0,-1220,0,-1227
409,1230,1230,1223,-1230,1,-1223,-1,-1230
410,1233,1233,1226,-1233,0,-1226,0,-1233
411,1236,1236,1229,-1236,1,-1229,-1,-1236
412,1239,1239,1232,-1239,0,-1232,0,-1239
413,1242,1242,1235,-1242,1,-1235,-1,-1242
414,1245,1245,1238,-1245,0,-1238,0,-1245
415,1248,1248,1241,-1248,1,-1241,-1,-1248
416,1251,1251,1244,-1251,0,-1244,0,-1251
417,1254,1254,1247,-1254,1,-1247,-1,-1254
418,1257,1257,1250,-1257,0,-1250,0,-1257
419,1260,1260,1253,-1260,1,-1253,-1,-1260
420,1263,1263,1256,-1263,0,-1256,0,-1263
421,1266,1266,1259,-1266,1,-1259,-1,-1266
422,1269,1269,1262,-1269,0,-1262,0,-1269
423,1272,1272,1265,-1272,1,-1265,-1,-1272
424,1275,1275,1268,-1275,0,-1268,0,-1275
425,1278,1278,1271,-1278,1,-1271,-1,-1278
426,1281,1281,1274,-1281,0,-1274,0,-1281
427,1284,1284,1277,-1284,1,-1277,-1,-1284
428,1287,1287,1280,-1287,0,-1280,0,-1287
429,1290,1290,1283,-1290,1,-1283,-1,-1290
430,1293,1293,1286,-1293,0,-1286,0,-1293
431,1296,1296,1289,-1296,1,-1289,-1,-1296
432,1299,1299,1292,-1299,0,-1292,0,-1299
433,1302,1302,1295,-1302,1,-1295,-1,-1302
434,1305,1305,1298,-1305,0,-1298,0,-1305
435,1308,1308,1301,-1308,1,-1301,-1,-1308
436,1311,1311,1304,-1311,0,-1304,0,-1311
437,1314,1314,1307,-1314,1,-1307,-1,-1314
438,1317,1317,1310,-1317,0,-1310,0,-1317
439,1320,1320,1313,-1320,1,-1313,-1,-1320
440,1323,1323,1316,-1323,0,-1316,0,-1323
441,1326,1326,1319,-1326,1,-1319,-1,-1326
442,1329,1329,1322,-1329,0,-1322,0,-1329
443,1332,1332,1325,-1332,1,-1325,-1,-1332
444,1335,1335,1328,-1335,0,-1328,0,-1335
445,1338,1338,1331,-1338,1,-1331,-1,-1338
446,1341,1341,1334,-1341,0,-1334,0,-1341
447,1344,1344,1337,-1344,1,-1337,-1,-1344
448,1347,1347,1340,-1347,0,-1340,0,-1347
449,1350,1350,1343,-1350,1,-1343,-1,-1350
450,1353,1353,1346,-1353,0,-1346,0,-1353
451,1356,1356,1349,-1356,1,-1349,-1,-1356
452,1359,1359,1352,-1359,0,-1352,0,-1359
453,1362,1362,1355,-1362,1,-1355,-1,-1362
454,1365,1365,1358,-1365,0,-1358,0,-1365
455,1368,1368,1361,-1368,1,-1361,-1,-1368
456,1371,1371,1364,-1371,0,-1364,0,-1371
457,1374,1374,1367,-1374,1,-1367,-1,-1374
458,1377,1377,1370,-1377,0,-1370,0,-1377
459,1380,1380,1373,-1380,1,-1373,-1,-1380
460,1383,1383,1376,-1383,0,-1376,0,-1383
461,1386,1386,1379,-1386,1,-1379,-1,-1386
462,1389,1389,1382,-1389,0,-1382,0,-1389
463,1392,1392,1385,-1392,1,-1385,-1,-1392
464,1395,1395,1388,-1395,0,-1388,0,-1395
465,1398,1398,1391,-1398,1,-1391,-1,-1398
466,1401,1401,1394,-1401,0,-1394,0,-1401
467,1404,1404,1397,-1404,1,-1397,-1,-1404
468,1407,1407,1400,-1407,0,-1400,0,-1407
469,1410,1410,1403,-1410,1,-1403,-1,-1410
470,1413,1413,1406,-1413,0,-1406,0,-1413
471,1416,1416,1409,-1416,1,-1409,-1,-1416
472,1419,1419,1412,-1419,0,-1412,0,-1419
473,1422,1422,1415,-1422,1,-1415,-1,-1422
474,1425,1425,1418,-1425,0,-1418,0,-1425
475,1428,1428,1421,-1428,1,-1421,-1,-1428
476,1431,1431,1424,-1431,0,-1424,0,-1431
477,1434,1434,1427,-1434,1,-1427,-1,-1434
478,1437,1437,1430,-1437,0,-1430,0,-1437
479,1440,1440,1433,-1440,1,-1433,-1,-1440
480,1443,1443,1436,-1443,0,-1436,0,-1443
481,1446,1446,1439,-1446,1,-1439,-1,-1446
482,1449,1449,1442,-1449,0,-1442,0,-1449
483,1452,1452,1445,-1452,1,-1445,-1,-1452
484,1455,1455,1448,-1455,0,-1448,0,-1455
485,1458,1458,1451,-1458,1,-1451,-1,-1458
486,1461,1461,1454,-1461,0,-1454,0,-1461
487,1464,1464,1457,-1464,1,-1457,-1,-1464
488,1467,1467,1460,-1467,0,-1460,0,-1467
489,1470,1470,1463,-1470,1,-1463,-1,-1470
490,1473,1473,1466,-1473,0,-1466,0,-1473
491,1476,1476,1469,-1476,1,-1469,-1,-1476
492,1479,1479,1472,-1479,0,-1472,0,-1479
493,1482,1482,1475,-1482,1,-1475,-1,-1482
494,1485,1485,1478,-1485,0,-1478,0,-1485
495,1488,1488,1481,-1488,1,-1481,-1,-1488
496,1491,1491,1484,-1491,0,-1484,0,-1491
497,1494,1494,1487,-1494,1,-1487,-1,-1494
498,1497,1497,1490,-1497,0,-1490,0,-1497
499,1500,1500,1493,-1500,1,-1493,-1,-1500
